year,R,S,P,Shortfall,PopulationCovered,per_1000
2005,408,862,862,-454,36836,23.40
2006,408,570,433,-25,36836,11.75
2007,411,580,350,61,36568,9.57
2008,420,580,350,70,35480,9.86
2009,437,614,427,10,34392,12.42
2010,441,651,513,-72,34080,15.05
2011,444,651,530,-86,37233,14.23
2012,447,481,342,105,36983,9.25
2013,452,506,393,59,36525,10.76
2014,454,577,395,59,36364,10.86
